3333333333333333333333333333333333333333
3000000000000000000000000000000000000003
3000S00000333333000000333333000000S00003
3000000000300003000000300003000000000003
3000000000300E03000000300E03000000000003
3000333333322223333333322223333333000003
3000300000000000000000000000000030000003
3000300H00000000000000000000000H03000003
3000300000022222222222220000000030000003
3000300000022211111122220000000030000003
3000300000022211T11222200000000300000003
3000300000022211111122220000000030000003
3000300000022222222222220000000030000003
3000300H00000000000000000000000H03000003
3000300000000000000000000000000030000003
3000333333322223333333322223333333000003
3000000000300E03000000300E03000000000003
3000000000300003000000300003000000000003
3000S00000333333000000333333000000S00003
3000000000000000000000000000000000000003
3000000000000000000000000000000000000003
300000000000000000000000000000000000P003
3000000000000000000000000000000000000003
3000000000000000000000000000000000000003
3333333333333333333333333333333333333333