000000000000000000000000000000000000000
300000000000000000000000000000000000000
000000000000000000000000000000000000000
000000000000000000000000000000000000300
000000000000000000000000000000000000000
000300000000000000000000000000000000000
000000000000000000000000000000000000000
000000000000000000000300000000000000000
000040000000000000000000000000000040000
000000000000000000000000000000000000000
000004000000000000000000000000004000000
000000000000000000000000000000000000000
000000000000000000000000000000000000000
000000000000000000000000000000000000000
000000000000000000000000000000000000000
000000000000000000000000000000000000000
000002222200000000002222220000000022200
000022222220000000022222222000000222220
000220000002000000220000002200002000002
000000000000000000000000000000000000000
000000000000000000000000000000000000000
000000000000000000000000000000000000000
000000000000000000000000000000000000000
000000000000000500000000000000000000000
000000000000000000000000000000000000000