0000000000000000000000000000000000000000
0000000000000000000000000000000000000000
00000000000S000000000000000S000000000000
0000000000000000000000000000000000000000
0000000000000000000000000000000000000000
00003333000000E000000E000000333300000000
0000322300000000000000000000032230000000
00003223000H000000000000000H032230000000
0000322300000000000000000000032230000000
0000333300000000000000000000033330000000
0000000000000000000000000000000000000000
0000000000T0000000000000000T000000000000
0000000000000000000000000000000000000000
0000000000000222222222220000000000000000
0000000000000222222222220000000000000000
0000000000000222222222220000000000000000
0000000000000000000000000000000000000000
00000E000000000000000000000000E000000000
0000000000000000000000000000000000000000
0000000000000000000000000000000000000000
0000000000000000000000000000000000000000
0000000000000000000000000000000000000000
0000000000000000000000000000000000000000
0000000000000000000000000000000000000000
000000000000000000P000000000000000000000