000000000000000000000000000000000000000
011111000000111110000000000000000000000
010101000000100011000000000000000000000
011111000030111110000000000000000000000
000000000000000000000000000000000000000
000300000000000000000000000000000000000
000000000000000030000000000000000000000
000000000000000000000000000000000000000
000040000000000000000000000000000000000
000000000000000000000000000000000000000
222222200002222222200022222000000000000
002000020020000000020000000000000000000
000000000000000000000000000000000000000
000000000000000000000000000000000000000
000000000000000000000000000000000000000
000000000000000000000000000000000000000
000000000000000000000000000000000000000
000000000000000000000000000000000000000
000000000000000000000000000000000000000
000000000000000000000000000000000000000