000000000000000000000000000000000000000
E00000000000000000000000000000000000000
000000000000000000000000000000000000000
000000000000000000000000000000000000E00
000000000000000000000000000000000000000
000E00000000000000000000000000000000000
000000000000000000000000000000000000000
000000000000000000000E00000000000000000
0000H00000000000000000000000000000H0000
000000000000000000000000000000000000000
00000H00000000000000000000000000H000000
000000000000000000000000000000000000000
000000000000000000000000000000000000000
000000000000000000000000000000000000000
000000000000000000000000000000000000000
000000000000000000000000000000000000000
000002222200000000002222220000000022200
000022222220000000022222222000000222220
000220000002000000220000002200002000002
000000000000000000000000000000000000000
000000000000000000000000000000000000000
000000000000000000000000000000000000000
000000000000000000000000000000000000000
00P000000000000000000000000000000000000
000000000000000000000000000000000000000